111111
102001
100001
111111
100031
111111