###############
#      #      #
# ## #   # ## #
# #   # #   # #
#   #     #   #
# # #  #  # # #
# #    #    # #
# # #  #  # # #
#   #     #   #
# #   # #   # #
# ## #   # ## #
#      #      #
###############
