###############
#   #     #   #
# #   # #   # #
# #    #    # #
#   # ### #   #
# #   # #   # #
### #     # ###
# #   # #   # #
#   # ### #   #
# #    #    # #
# #   # #   # #
#   #     #   #
###############
