###############
#     ###     #
# ###     ### #
#     ###     #
#     ###     #
# #         # #
# #  # # #  # #
# #         # #
#     ###     #
#     ###     #
# ###     ### #
#     ###     #
###############
