###############
#    # # #    #
# #         # #
# # #  #  # # #
#             #
# # #  #  # # #
#      #      #
# # #  #  # # #
#             #
# # #  #  # # #
# #         # #
#    # # #    #
###############
