###############
#      #      #
# # # # # # # #
#   #     #   #
# # # ### # # #
#             #
# # ### ### # #
#             #
# # # ### # # #
#   #     #   #
# # # # # # # #
#      #      #
###############
