######
#P   #
#X   #
#    #
######
