######
#    #
#    #
#P   #
#    ######
#         #
#         #
###########
