11111111
10000001
10000001
10000001
10200001
10000001
11110111
