111111111
100000001
100020001
100010001
100101001
101000101
100000001
111111111
