11111111111
10000200001
10101010101
10000000001
10101010101
10000000001
10101010101
10000000031
11111111111