111111111
100020001
100000001
101000101
100101001
100010001
100101001
101000101
130000001
111111111